27 18 18 18 18 18 18 18 18 18 18 18 18 18 18 18 18 18 18 18 18 18 18 18 18 18 18 18 18 18 18 18 18 18 18 18 18 18 18 18 18 18 18 18 18 18 18 18 18 18 
18 18 18 18 18 18 18 18 18 18 18 18 18 18 18 18 18 18 18 18 18 18 18 18 18 18 27 18 18 18 18 18 18 18 18 18 18 18 18 18 18 18 18 18 18 18 18 18 18 18 
18 27 18 18 18 18 18 18 18 18 18 18 18 18 18 18 18 18 18 27 18 18 18 18 18 18 18 18 18 18 18 18 18 18 18 18 18 18 18 18 18 18 18 18 18 18 18 27 18 18 
18 18 18 18 18 18 27 18 18 18 18 18 18 18 18 27 18 18 18 18 18 18 18 18 18 18 18 27 18 18 18 18 18 18 18 18 18 18 27 18 18 18 18 18 18 18 18 18 18 18 
18 18 18 18 18 18 18 18 18 18 18 18 18 18 18 18 18 18 18 18 18 18 18 18 18 18 18 18 18 18 18 18 18 18 18 18 18 18 18 18 18 18 18 18 18 18 18 18 18 18 
18 18 18 18 27 18 18 18 18 18 18 18 18 18 18 18 18 18 18 18 18 18 27 18 18 18 18 18 18 18 18 18 18 27 18 18 18 27 18 18 18 18 18 18 18 27 18 18 18 18 
18 18 18 18 18 18 18 18 18 18 18 18 18 18 18 18 18 18 18 18 18 18 18 18 18 18 27 18 18 18 27 18 18 18 18 18 18 18 18 18 28 17 17 29 18 18 18 27 18 18 
18 18 18 18 18 18 18 18 18 18 18 18 18 18 28 17 17 17 17 17 17 17 29 18 18 18 18 18 18 18 18 18 18 18 18 18 18 18 18 18 15 0 2 16 18 18 18 18 18 18 
18 27 18 18 18 18 18 18 18 18 28 17 17 17 12 0 0 0 0 0 0 0 13 17 17 17 17 29 28 17 17 17 29 18 18 18 18 18 27 18 30 11 0 16 18 18 18 18 18 18
18 18 18 18 18 18 18 18 18 28 12 0 0 0 0 0 0 0 0 0 0 0 0 0 0 0 0 13 12 0 0 0 13 17 29 27 18 18 18 18 28 12 0 16 18 18 18 18 18 18 
18 18 18 18 18 18 18 18 18 15 0 0 0 0 0 0 0 1 0 0 0 0 0 0 0 0 0 0 0 0 2 0 0 0 13 17 29 18 18 18 15 1 10 31 18 27 18 18 18 18 
18 18 18 18 18 18 18 18 28 12 0 0 2 0 0 0 0 0 0 0 0 0 0 6 9 9 9 9 9 6 0 0 0 0 0 0 13 17 17 29 30 14 31 18 18 18 18 18 18 18 
18 18 18 18 27 18 18 18 15 0 1 0 0 0 0 0 0 0 0 0 0 0 0 8 7 7 7 7 7 8 0 0 0 0 0 0 0 0 0 13 29 18 18 18 18 18 18 18 18 18 
18 18 18 18 18 18 18 28 12 0 0 0 0 0 1 0 0 0 0 0 0 0 0 8 7 7 7 7 7 8 0 0 0 0 0 1 0 0 0 0 16 27 18 18 18 18 18 18 18 18 
18 18 18 18 18 18 18 15 0 0 0 0 0 0 0 0 0 0 0 0 0 0 1 8 7 7 7 7 7 8 0 0 0 0 0 0 0 0 0 10 31 18 18 18 18 18 18 18 27 18 
18 18 18 18 18 18 18 15 0 0 0 0 0 0 0 0 0 2 0 0 0 0 0 6 9 9 7 9 9 6 0 0 0 0 0 0 0 0 10 31 28 17 29 18 18 18 27 18 18 18 
18 18 18 18 18 18 18 15 0 0 2 0 0 0 0 0 0 0 0 0 0 2 0 0 52 0 41 0 52 0 0 0 0 2 0 0 0 0 13 17 12 0 16 18 18 18 18 18 18 18 
18 18 18 18 18 18 18 15 0 0 0 0 0 0 0 0 0 0 0 0 0 0 0 0 53 0 41 0 53 0 0 0 0 0 0 52 0 0 0 0 0 10 31 18 18 18 18 18 18 18 
18 27 18 18 18 18 18 30 11 0 0 0 0 0 0 1 0 0 0 0 0 0 0 0 0 0 41 2 0 0 0 52 0 0 0 53 0 52 0 0 0 16 18 18 18 18 18 18 18 18 
18 18 18 18 18 18 18 18 30 11 0 1 0 0 0 0 42 36 36 36 36 36 36 36 36 36 37 0 0 0 52 53 52 52 52 0 0 53 0 0 0 13 29 18 18 27 18 18 18 18 
18 18 18 18 18 18 18 18 18 15 0 0 0 0 0 0 39 38 38 38 38 38 38 38 38 38 44 0 0 0 53 0 53 53 53 0 52 2 0 0 0 0 16 18 27 18 18 18 18 18 
18 18 18 18 18 18 18 18 28 12 0 0 0 0 0 0 41 0 0 0 0 0 0 0 0 0 1 0 0 0 0 10 14 14 14 11 53 0 1 0 0 0 16 18 18 18 18 18 18 18 
18 18 18 18 18 18 18 28 12 0 0 0 0 0 0 0 41 0 0 0 0 0 0 0 0 0 0 10 14 14 14 31 18 18 18 30 11 0 52 0 0 10 31 18 18 18 18 18 18 18 
18 18 27 18 18 18 18 15 0 0 0 1 0 0 0 0 41 0 0 0 0 0 0 0 0 0 10 31 18 18 18 18 18 18 18 18 15 0 53 0 0 16 18 18 18 18 18 18 18 18 
18 18 18 18 18 18 18 15 0 0 0 0 0 0 2 0 41 0 0 0 0 0 0 0 0 0 16 18 18 18 18 18 18 18 18 28 12 0 52 0 0 16 18 27 18 18 18 18 18 18 
18 18 18 18 18 18 18 15 0 0 0 0 0 0 0 0 41 0 0 0 0 0 0 0 0 0 13 29 18 18 18 18 18 28 17 12 0 0 53 0 0 13 29 18 18 18 18 18 27 18 
18 18 18 18 18 18 18 30 11 0 0 0 0 0 0 0 41 0 0 1 0 0 2 0 0 0 0 16 18 18 18 28 17 12 0 52 0 0 2 0 0 0 16 18 18 18 27 18 18 18 
18 18 18 18 18 18 18 18 34 11 0 0 0 0 0 0 41 0 0 0 0 0 0 0 0 0 0 13 29 28 17 12 0 0 0 53 0 0 0 0 0 10 31 18 18 18 18 18 18 18 
18 18 18 18 18 18 18 18 28 12 0 6 9 9 9 9 7 9 9 9 9 6 0 0 0 0 0 0 16 15 0 0 0 2 0 0 0 0 0 10 14 31 18 18 18 18 18 18 18 18 
18 27 18 18 18 18 18 18 15 0 0 8 7 7 7 7 7 7 7 7 7 8 0 0 0 0 0 0 16 30 11 0 0 0 0 1 0 10 14 31 28 17 29 18 18 18 18 18 18 18 
18 18 18 18 18 18 18 18 15 0 0 8 7 7 7 7 7 7 7 7 7 8 1 0 0 0 1 0 13 29 30 14 14 14 14 14 14 31 28 17 12 0 16 18 18 18 18 18 18 18 
18 18 18 18 18 18 18 28 12 0 0 8 7 7 7 7 7 7 7 7 7 8 0 0 0 0 0 0 0 13 17 17 29 28 17 29 18 18 15 0 2 0 13 29 27 18 18 18 18 18 
18 18 18 18 18 18 18 15 0 0 2 8 7 7 7 7 7 7 7 7 7 8 0 0 0 0 5 4 4 5 0 0 13 12 1 13 17 29 30 14 11 0 1 16 18 18 18 18 18 18 
18 18 18 18 18 18 18 15 0 0 0 8 7 7 7 7 7 7 7 7 7 8 0 0 0 0 4 0 0 4 0 0 0 0 0 0 0 13 17 29 30 14 14 31 18 18 18 18 18 18 
18 18 18 18 27 18 18 30 11 0 0 8 7 7 7 7 7 7 7 7 7 8 0 0 0 0 4 0 0 4 0 0 0 0 0 0 0 0 0 13 17 29 18 18 18 18 18 18 18 18 
18 18 18 18 18 18 18 18 15 0 0 6 9 9 9 9 9 9 9 9 9 6 0 0 0 0 5 1 0 5 0 1 0 0 0 0 0 1 0 0 0 13 29 18 18 18 18 18 18 18 
18 18 18 18 18 18 18 18 15 0 0 0 0 0 0 0 0 0 0 0 0 0 0 0 0 0 0 0 0 0 0 0 0 0 0 0 0 0 0 0 0 0 16 18 18 18 18 18 18 18 
18 18 18 18 18 18 18 18 30 14 14 11 1 0 0 0 0 0 0 0 0 0 0 0 0 2 0 0 1 0 0 0 0 0 2 0 0 0 0 0 0 0 16 18 18 18 18 27 18 18 
18 18 18 18 18 18 18 18 18 18 18 30 14 11 0 0 0 0 2 0 0 0 1 0 0 0 0 0 0 0 0 0 0 0 0 0 0 0 0 0 1 0 16 18 18 18 18 18 18 18 
18 18 18 18 18 18 18 18 28 17 17 17 29 30 11 0 0 0 0 0 0 0 0 0 0 0 0 0 0 0 0 1 0 0 0 0 0 0 0 0 0 10 31 18 18 18 18 18 18 18 
18 18 27 18 18 18 18 28 12 0 2 0 13 29 15 0 0 0 0 0 0 0 0 0 10 14 14 14 14 11 0 0 0 0 0 0 0 0 2 0 10 31 18 18 18 18 18 18 18 18 
27 18 18 18 18 18 18 15 1 0 0 0 0 16 30 14 11 1 0 0 10 14 14 14 31 18 18 18 18 30 11 0 0 10 14 14 14 14 14 14 31 18 18 18 27 18 18 18 18 18 
18 18 18 18 18 18 18 30 14 14 14 14 14 31 18 18 30 14 14 14 31 18 18 18 18 18 27 18 18 18 30 14 14 31 18 18 18 18 18 18 18 18 18 18 18 18 27 18 18 18 
18 18 18 18 18 18 18 18 18 18 18 18 18 18 18 18 18 18 18 18 18 18 18 18 18 18 18 18 18 18 18 18 18 18 18 18 18 18 18 18 18 18 18 18 18 18 18 18 18 18 
18 18 18 18 18 18 18 18 18 18 27 18 18 18 18 18 18 27 18 18 18 18 18 18 27 18 18 18 18 18 18 18 18 18 18 18 18 18 18 18 18 18 18 18 18 18 18 18 18 18 
18 18 18 18 27 18 18 18 18 18 18 18 18 27 18 18 18 18 18 18 18 18 18 18 18 18 18 18 18 18 18 18 18 18 18 18 18 18 18 27 18 18 18 18 18 18 18 18 18 18 
18 18 18 18 18 18 18 18 18 18 18 18 18 18 18 18 18 18 18 18 18 18 18 18 18 18 18 18 18 18 18 18 18 18 18 18 18 18 18 18 18 18 18 18 18 18 18 18 18 18 
27 18 18 18 18 18 18 18 18 18 18 18 18 18 18 18 18 18 18 18 18 18 18 18 18 18 18 18 18 27 18 18 18 18 18 18 18 18 18 18 18 18 18 18 18 18 18 18 18 18 
18 18 18 18 18 18 27 18 18 18 18 18 18 18 18 18 18 18 18 18 18 18 18 27 18 18 18 18 18 18 18 18 18 18 18 18 18 18 18 18 27 18 18 18 18 18 18 27 18 18 
18 18 18 18 18 18 18 18 18 18 18 18 18 18 18 18 18 18 18 18 18 18 18 18 18 18 18 18 18 18 18 18 18 18 18 18 18 18 18 18 18 18 18 18 18 18 18 18 18 18 
